17,,,,,3,3,11,11,3,3,3,3,3,12,,,,,,,,,,4,12,,,2,,,2,2,2,2,,2,2,2,2,,,,,,2,2,,,,,,,,,,,,,,,,,,,,,,,,,2,,,,,,,,,,,,,,,,,,,,,,,,,,,,,
16,,,,,,,,,,,,,,2,,,,,,4,4,,,,2,,,2,,,2,2,2,2,,,2,,,,,,,,2,2,,,,,,,,,,,,,,,,,,,,,,,,,2,,,,,,,,,,,,,,,,,,,,,,,,,,,,,
16,13,13,,,,,,4,,,,,,2,,,,,,,,,,,2,,2,,,,,,,2,,,2,,,,2,2,,,2,2,,,,,,,,,,,,,,,,,,,,,,,,,2,,,,,,,,,,,,,,,,,,,,,,,,,,,,,
16,13,13,13,13,6,,,10,,11,11,,,2,,,12,13,13,13,,,,,2,,2,,,,,,,2,,,2,,,,2,2,,,,,,,,,,,,,,,,,,,,,,,,,,,,,2,,,,,,,,,,,,,,,,,,,,,,,,,,,,,
16,3,3,3,3,3,3,3,3,3,,,,,2,,,2,,,,,,,,2,,2,,,,,,,2,,,2,,,,2,2,,,,,,,,,,,,,,,,,,,,,,,,,,,,,2,,,,,,,,,,,,,,,,,,,,,,,,,,,,,
16,,,,,,,,,,,,4,,2,,,2,,,,,,,,2,,2,,,,,,,2,,,2,,,,2,2,,,,,,,,,,,,,,,,,,,4,4,4,,,,,,,,,,,,,,,,,,,,,,,,,,,,,,,,,,,,,
16,,,,,,,,,8,,,,13,2,,,2,,,,,8,,,2,,2,2,,,4,4,4,2,,,2,,,,2,2,,,4,,,,,,,,,,,,,,1,,,,,,1,,,,,,,300,,,,,,,,,,,,,,,,,,,,,,,,,,,,
16,,,3,3,3,3,3,3,3,3,13,13,13,2,,,2,,,13,13,13,13,13,2,,,2,,,4,4,4,2,,,2,4,2,,2,2,,,2,2,,,,,,,,,,,,,1,4,1,1,1,4,1,,,,,2,2,2,2,2,2,2,2,2,2,2,2,2,2,2,2,2,2,2,2,2,2,2,2,2,2,2,2,2,2,2
16,,,,,,,,,,,,4,4,2,,,2,,,,,,,,2,,,2,,,2,2,2,2,,,2,2,2,,,,,,,,,,,,,,,,2,,,,1,1,1,,1,1,1,,,,,2,2,2,2,2,2,2,2,2,2,2,2,2,2,2,2,2,2,2,2,2,2,2,2,2,2,2,2,2,2,2
16,,,,,,,,,,,,4,4,2,,,2,,,,,,,,,,,,,,,,,,,,,,,,,,,,,,,,,,,2,,,2,,,,,,,,,,,,,,2,2,2,2,2,2,2,2,2,2,2,2,2,2,2,2,2,2,2,2,2,2,2,2,2,2,2,2,2,2,2,2
15,3,3,10,,,,,,10,,7,4,4,2,,,2,,,,7,,,,,,,,,,,,,,,,7,,,,7,,,7,,,,,2,18,18,2,18,18,2,,,,,7,,,,7,,,,,2,2,2,2,2,2,2,2,2,2,2,2,2,2,2,2,2,2,2,2,2,2,2,2,2,2,2,2,2,2,2,2
1,1,1,1,1,1,1,1,1,1,1,1,1,1,1,,,1,1,1,1,1,1,1,1,1,1,1,1,1,1,1,1,1,1,1,1,1,1,1,1,1,1,1,1,1,1,1,1,1,1,1,1,1,1,1,1,1,1,1,1,1,1,1,1,1,1,1,1,1,1,1,1,1,1,1,1,1,1,1,1,1,1,1,1,1,1,1,1,1,1,1,1,1,1,1,1,1,1,1,1
